0 2 2 2 2 2 2 0 0 2 2 2 2 2 2 0 0 2 2 2 2 2 2 0
0 7 7 7 7 7 0 0 0 7 7 7 7 7 7 0 0 0 7 7 7 7 7 0
0 2 2 2 0 2 2 0 0 2 2 2 2 2 2 0 0 0 2 2 2 2 2 0
0 2 6 2 3 2 6 0 0 2 6 6 2 6 2 0 0 6 3 2 6 6 3 0
0 2 6 2 2 6 2 0 0 2 6 2 2 6 2 0 0 2 6 2 2 6 2 0
0 10 10 10 10 10 10 0 0 10 10 10 10 10 10 0 0 10 10 10 10 10 10 0
0 6 6 6 6 6 6 0 0 6 6 6 6 6 6 0 0 6 6 6 6 6 6 0
0 7 7 7 7 7 7 0 0 7 7 7 7 7 7 0 0 7 7 7 7 7 7 0
0 6 6 4 4 6 6 0 0 6 4 4 4 4 6 0 0 6 6 4 4 6 6 0
0 4 4 6 6 4 4 0 0 4 4 6 6 4 4 0 0 4 4 6 6 4 4 0
0 4 6 6 6 6 4 0 0 4 6 6 6 6 4 0 0 4 6 6 6 6 4 0
0 2 8 2 2 8 2 0 0 2 2 2 2 2 2 0 0 2 8 2 2 8 2 0
0 8 2 8 8 2 8 0 0 2 2 2 2 2 2 0 0 8 2 8 8 2 8 0
0 2 10 2 10 2 2 0 0 10 2 2 2 2 10 0 0 2 2 10 2 10 2 0
0 2 2 10 10 2 2 0 0 2 10 10 10 10 2 0 0 2 2 10 10 2 2 0
0 2 2 2 10 10 2 0 0 2 2 10 10 2 2 0 0 2 10 10 2 2 2 0
0 10 2 2 2 2 10 0 0 10 10 2 2 10 10 0 0 2 10 10 10 10 2 0
0 3 3 3 3 3 3 0 0 3 3 3 3 3 3 0 0 3 3 3 3 3 3 0
0 0 0 2 2 0 0 0 0 2 2 2 2 2 2 0 0 2 0 2 2 0 2 0
0 2 2 0 0 2 2 0 0 2 2 2 2 2 2 0 0 2 2 0 0 2 2 0
0 0 0 2 2 0 0 0 0 0 2 2 2 2 0 0 0 2 2 2 2 2 2 0
0 2 2 3 2 2 3 0 0 3 6 3 3 6 3 0 0 3 2 2 3 2 2 0
0 2 6 2 2 2 3 0 0 2 2 3 6 2 2 0 0 3 2 2 2 3 2 0
0 2 2 2 3 2 6 0 0 6 3 6 2 3 2 0 0 2 2 3 2 6 2 0
0 2 6 6 6 3 2 0 0 3 6 3 6 2 2 0 0 2 2 2 3 6 2 0
0 2 2 6 6 2 2 0 0 2 6 6 6 6 2 0 0 2 2 6 6 2 2 0
0 2 2 2 2 2 2 0 0 2 6 6 6 6 2 0 0 2 2 2 2 2 2 0
0 2 2 6 6 6 6 0 0 2 6 6 6 6 2 0 0 6 6 6 6 2 2 0
0 2 2 2 2 2 2 0 0 2 6 2 2 6 2 0 0 2 2 2 2 2 2 0
0 6 2 6 6 2 6 0 0 6 2 6 6 2 6 0 0 6 2 6 6 2 6 0
0 6 6 6 6 6 6 0 0 2 2 2 2 2 2 0 0 6 6 6 6 6 6 0
0 2 2 2 2 2 2 0 0 2 9 2 2 9 2 0 0 2 2 2 2 2 2 0
0 3 3 3 3 3 3 0 0 2 2 2 2 2 2 0 0 3 3 3 3 3 3 0
0 3 3 2 2 2 3 0 0 3 3 2 2 3 3 0 0 3 2 2 2 3 3 0
0 2 2 3 2 2 3 0 0 2 3 3 2 2 2 0 0 2 2 2 3 3 2 0
0 2 2 2 2 2 2 0 0 3 2 3 3 2 3 0 0 2 2 2 2 2 2 0
0 2 3 2 3 2 2 0 0 2 2 2 2 2 2 0 0 2 2 3 2 3 2 0
0 2 2 2 3 2 2 0 0 2 3 2 2 2 3 0 0 3 2 2 2 2 2 0
0 3 2 3 2 2 3 0 0 2 2 2 2 2 2 0 0 3 2 2 3 2 3 0
0 2 2 3 3 3 3 0 0 2 3 3 3 2 2 0 0 2 2 3 2 2 2 0
0 2 2 2 2 2 3 0 0 2 2 2 2 2 2 0 0 2 3 2 2 2 2 0
0 3 3 2 2 3 3 0 0 2 2 2 2 2 2 0 0 2 2 3 3 2 2 0
0 2 2 2 2 2 2 0 0 3 3 3 3 3 3 0 0 2 2 2 2 2 2 0
0 2 2 2 7 2 2 0 0 2 7 7 2 7 7 0 0 7 2 7 2 7 2 0
0 2 7 7 2 2 2 0 0 2 2 2 7 2 2 0 0 2 7 2 2 7 7 0
0 2 2 2 2 7 7 0 0 7 2 7 2 2 7 0 0 7 2 2 7 2 2 0
0 2 7 2 2 2 2 0 0 2 2 7 2 2 7 0 0 7 2 2 7 2 2 0
0 2 2 7 2 2 7 0 0 2 7 2 2 2 2 0 0 2 2 2 2 7 2 0
0 2 2 7 2 7 2 0 0 2 7 2 7 2 7 0 0 2 2 7 2 2 2 0
0 7 2 2 7 2 7 0 0 7 7 7 7 7 7 0 0 7 2 7 2 2 7 0
0 7 2 7 7 2 7 0 0 2 7 7 7 7 2 0 0 7 2 7 7 2 7 0
0 2 7 2 7 2 7 0 0 7 2 7 2 7 2 0 0 2 7 2 7 2 7 0
0 2 2 0 0 2 2 0 0 2 2 2 2 2 2 0 0 0 2 2 2 2 0 0
0 2 2 2 2 2 2 0 0 2 0 2 2 0 2 0 0 2 2 2 2 2 2 0
0 0 2 2 0 2 2 0 0 2 2 0 2 2 0 0 0 2 2 2 2 2 2 0
0 2 9 2 2 2 2 0 0 2 2 2 2 2 2 0 0 2 2 2 2 9 2 0
0 2 7 2 2 7 2 0 0 2 7 2 2 7 2 0 0 2 7 2 2 7 2 0
0 2 7 7 7 7 2 0 0 2 7 7 7 7 2 0 0 2 7 7 7 7 2 0
0 2 2 2 7 7 2 0 0 2 7 7 7 7 2 0 0 2 7 7 2 2 2 0
0 7 7 2 2 7 7 0 0 7 7 2 2 7 7 0 0 7 7 2 2 7 7 0
0 7 7 2 2 2 2 0 0 7 7 2 2 7 7 0 0 2 2 2 2 7 7 0
0 7 7 7 2 2 2 0 0 7 7 7 2 2 2 0 0 7 7 7 2 2 2 0
0 2 2 2 10 10 10 0 0 2 2 2 10 10 10 0 0 2 2 2 10 10 10 0
0 0 7 7 7 7 7 0 0 7 7 7 7 7 7 0 0 7 7 7 7 7 0 0
0 2 2 2 2 2 2 0 0 2 2 2 2 0 2 0 0 2 2 2 2 2 2 0
0 2 2 2 2 9 2 0 0 2 2 2 2 2 2 0 0 2 9 2 2 2 2 0
0 2 9 2 2 9 2 0 0 2 2 2 2 2 2 0 0 2 9 2 2 9 2 0
0 6 4 4 6 6 6 0 0 6 6 4 4 6 6 0 0 6 6 6 4 4 6 0
0 6 4 4 4 4 6 0 0 6 4 4 4 4 6 0 0 6 4 4 4 4 6 0
0 6 6 6 6 4 4 0 0 4 4 6 6 4 4 0 0 4 4 6 6 6 6 0
0 6 6 6 6 6 6 0 0 4 4 4 4 4 4 0 0 6 6 6 6 6 6 0
0 6 4 6 4 6 6 0 0 6 6 4 6 6 4 0 0 4 6 6 4 6 6 0
0 4 6 4 6 4 6 0 0 6 6 6 6 6 6 0 0 6 4 6 4 6 4 0
0 6 6 6 6 6 4 0 0 6 4 6 6 6 4 0 0 4 6 6 6 6 6 0
0 6 6 4 4 6 6 0 0 6 6 4 4 6 6 0 0 6 6 4 4 6 6 0
0 6 4 6 6 6 6 0 0 6 4 6 6 4 6 0 0 6 6 6 6 4 6 0
0 6 6 4 6 6 4 0 0 6 4 6 6 4 6 0 0 4 6 6 4 6 6 0
0 8 2 8 8 2 8 0 0 8 2 8 8 2 8 0 0 8 2 8 8 2 8 0
0 2 2 8 8 2 2 0 0 2 2 8 8 2 2 0 0 2 2 8 8 2 2 0
0 2 2 2 8 8 2 0 0 2 2 8 8 2 2 0 0 2 8 8 2 2 2 0
0 2 2 2 2 2 8 0 0 8 2 8 8 2 8 0 0 8 2 2 2 2 2 0
0 8 2 2 2 2 8 0 0 8 2 2 2 2 8 0 0 8 2 2 2 2 8 0
0 2 2 2 2 2 2 0 0 2 2 8 8 2 2 0 0 2 8 8 8 8 2 0
0 2 2 8 8 2 2 0 0 8 2 2 2 2 2 0 0 2 2 2 8 2 2 0
0 4 4 4 4 4 4 0 0 4 2 4 4 2 4 0 0 4 4 4 4 4 4 0
0 8 2 2 2 2 2 0 0 2 2 2 2 2 8 0 0 2 8 2 2 2 8 0
0 2 2 2 2 2 2 0 0 2 2 2 2 2 2 0 0 8 8 8 8 8 8 0
0 8 8 2 2 2 2 0 0 8 2 2 2 2 8 0 0 2 2 2 2 8 8 0
0 8 8 8 2 2 8 0 0 8 2 2 2 2 8 0 0 8 2 2 8 8 8 0
0 2 2 8 2 2 2 0 0 2 2 2 2 2 8 0 0 2 8 2 2 8 2 0
0 2 2 8 8 2 2 0 0 8 2 8 8 2 2 0 0 2 2 2 8 2 2 0
0 8 2 2 2 2 8 0 0 2 2 8 8 2 2 0 0 2 2 8 8 2 2 0
0 7 7 7 7 7 7 0 0 7 0 7 7 0 7 0 0 7 7 7 7 7 7 0
0 7 7 7 7 7 7 0 0 7 7 0 0 7 7 0 0 7 7 7 7 7 7 0
0 7 7 0 7 7 7 0 0 7 7 7 7 7 7 0 0 7 7 7 7 7 0 0
0 7 7 7 7 7 7 0 0 0 0 7 0 0 7 0 0 7 7 7 7 7 7 0
0 0 7 7 7 0 7 0 0 7 7 7 7 7 7 0 0 7 7 0 7 7 7 0
0 7 0 7 7 7 0 0 0 7 7 7 7 7 7 0 0 7 7 7 0 7 7 0
0 7 7 7 7 7 7 0 0 9 7 7 7 7 9 0 0 7 7 7 7 7 7 0
0 7 7 0 0 7 7 0 0 7 7 7 7 7 7 0 0 8 7 7 7 7 8 0
0 7 7 2 2 7 7 0 0 7 9 2 2 9 7 0 0 7 7 2 2 7 7 0
0 2 2 2 2 2 2 0 0 5 5 5 5 5 5 0 0 2 2 2 2 2 2 0
0 2 5 5 5 5 2 0 0 2 5 5 5 5 2 0 0 2 5 5 5 5 2 0
0 2 2 0 0 2 2 0 0 2 2 0 0 2 2 0 0 2 2 0 0 2 2 0
0 0 2 2 2 2 0 0 0 2 2 2 2 2 2 0 0 0 2 2 2 2 0 0
0 0 2 2 2 2 0 0 0 0 2 2 2 2 0 0 0 0 2 2 2 2 0 0
0 2 2 0 0 2 2 0 0 2 2 0 0 2 2 0 0 2 2 2 2 2 2 0
0 2 0 0 0 0 2 0 0 2 2 2 2 2 2 0 0 2 0 2 2 0 2 0
0 2 2 0 2 0 2 0 0 2 2 0 2 0 2 0 0 2 2 2 2 2 0 0
0 8 10 8 8 10 8 0 0 7 2 7 7 2 7 0 8 10 8 8 10 8 0
0 5 5 5 5 5 5 0 0 5 5 5 5 5 5 0 0 5 5 5 5 5 5 0
0 0 2 2 2 2 0 0 0 0 2 0 0 2 0 0 0 0 2 2 2 2 0 0
0 4 2 9 9 2 4 0 0 4 2 9 9 2 4 0 0 4 2 9 9 2 4 0
0 3 3 3 3 3 3 0 0 3 2 0 0 2 3 0 0 3 3 3 3 3 3 0
0 4 7 4 4 7 4 0 0 7 2 7 7 2 7 0 0 4 7 4 4 7 4 0
0 8 8 2 2 8 8 0 0 8 2 2 2 2 8 0 0 2 2 8 8 2 2 0
0 2 5 5 5 5 2 0 0 5 2 2 2 2 5 0 0 2 5 5 5 5 2 0
0 8 6 6 6 6 8 0 0 8 6 6 6 6 8 0 0 8 6 6 6 6 8 0
0 10 10 7 7 7 7 0 0 10 10 7 7 7 7 0 0 10 10 7 7 7 7 0
0 0 0 0 2 2 2 0 0 2 2 2 2 2 2 0 0 0 0 0 2 2 2 0
0 4 6 8 8 6 4 0 0 4 6 8 8 6 4 0 0 4 6 8 8 6 4 0
0 6 6 10 10 7 7 0 0 6 6 10 10 7 7 0 0 6 6 10 10 7 7 0
0 5 2 0 0 2 5 0 0 5 2 0 0 2 5 0 0 5 2 0 0 2 5 0